wwwwww
wwFFFw
wwFFFw
wFFFww
wFFFww
wFFFww
wwpFFw
wwwwww