wwwwwwwwwwww
wwFFFFFFFFww
wwwFFFFFFFFw
wwwFFFFFFwww
wwFFFFFFFFFw
wwwwFFFFFFww
wFFFFFFFFFww
wwFFFFFFFFFw
wwwwwFFFFFFw
wwFFFFFFFFFw
wwFFFFFFFFFw
wFFFFFFFFwww
wwpFFFFFFwww
wwwwwwwwwwww